C    225,30,0           
NO   ./path_to_the_north_texture
SO   ./path_to_the_south_texture
WE   ./path_to_the_west_texture
EA   ./path_to_the_east_texture      
F    220,100,0



     11111001111111  110
111111   111111NE111
1111 111111111  11111
1 1111111
11 11
10
00      






